9 10
|--------|
|........|
|........|
|.@.|....|
|...|....|
|........|
|........|
|........|
|--------|