9 10
|--------|
|........|
|........|
|.@P|.F..|
|...|.F..|
|.F......|
|........|
|.....---|
|--------|