8 10
|--------|
|........|
|---|....|
|...|....|
|..-|.@..|
|........|
|--------|
|--------|