9 10
|--------|
|.....F..|
|---|....|
|...|....|
|..-|.@..|
|.....---|
|--......|
|...F.---|
|--------|